[Strings]
KEY_OPTIONAL = "SOFTWARE\Microsoft\Windows\CurrentVersion\Setup\OptionalComponents"
@*:IJK = "Internet Jumpstart Kit"
@*:IE_TIP = "World Wide Web Internet Browser"
HISTORY = "history"
CACHE = "cache"
LONG_INET_PROGRAMS = "Program Files\Plus!\Microsoft Internet"
DOCS_DIR = "docs"
INET_DESC = "Accessories\Internet Tools"
IEXPLORE_SHORT_DESC = "IEXPLORE"
IEXPLORE_DESC = "Internet Explorer"
URLHTTP = "URL:HyperText Transfer Protocol"
URLHTTPS= "URL:HyperText Transfer Protocol with Privacy"
URLFTP  = "URL:File Transfer Protocol"
URLTELNET = "URL:Telnet Protocol"
URLRLOGIN = "URL:RLogin Protocol"
URLTN3270 = "URL:TN3270 Protocol"
URLGOPHER = "URL:Gopher Protocol"
URLMAILTO = "URL:MailTo Protocol"
URLNEWS   = "URL:News Protocol"
URLFILE   = "URL:File Protocol"
THENET    = "Internet Explorer"
IDHTML    = "Internet Document (HTML)"
AUSOUND   = "AU Format Sound"
AIFF      = "AIFF Format Sound"
XBM       = "XBM Image"
GIF       = "GIF Image"
JPEG      = "JPEG Image"
ISHORTCUT = "Internet Shortcut"

WWW_MSN_COM  = "http://www.msn.com"
WWW_ALLINONE = "http://www.msn.com/access/allinone.htm"
